13 11
 0 0 0 0 0 0 0 0 0 0 0 0 0
0 0 1 2 0 0 0 0 1 1 2 1 0
 0 2 3 1 0 0 0 1 3 3 1 0 0
0 0 1 1 0 0 0 0 1 3 2 0 0
 0 0 1 1 0 0 0 0 1 2 0 0 0
0 0 1 2 2 1 1 0 0 0 0 0 0
 0 0 1 2 1 2 2 1 1 0 0 0 0
0 0 0 0 1 3 3 1 1 0 0 0 0
 0 0 0 1 3 2 1 0 0 0 0 0 0
0 0 0 0 1 1 0 0 0 0 0 0 0
 0 0 0 0 0 0 0 0 0 0 0 0 0

2
0 10 0
1 10 0

1
0 8 3 3
